From Every Tear A Pearl Is Born - Lili Rocha - IdEA
 
Spectrum - Zedd Featuring Matthew Koma - Interscope 
 
La Belle Et La Bête - Amanda Lear Featuring Andy Bell And DJ Yiannis - BoomLover/Universal France
 
Move In The Right Direction - Gossip - Columbia
 
Touch Me - Katharine McPhee - NBC /Columbia 
 
Perfect World - Gossip - Columbia  
 
Let’s Get It Started - Adriana Rubiano - Phatt Boi
 
DJ Love Song - Shyra Sanchez - Super Shy 
 
Be Your Freak - Kenny Dope Featuring  Josh Milan - Dope Wax
 
End of Time - Beyonce - Parkwood/Columbia
 
Blush - Dance On - Nettwerk
 
Hotel Nacional - Gloria Estefan - Crescent Moon / Verve
 
Let's Get Naughty - Jessie And The Toy Boys - Prospect
 
Erasure - Be With You - Mute
 
Wepa - Gloria Estefan - Crescent Moon
I Like Shoppin - Tené Williams  - SMG/Universal
High Off The Fame - Candyman 187 Featuring Snoop Dogg - We Got The Juice
 
Best Thing I Never Had - Beyonce - Parkwood/Columbia
 
Finally Free  - Kimberley Locke - IAME

Hollywood Tonight - Michael Jackson - MJJ/Epic

Talking To The Universe - Yoko Ono - Twisted/Mind Train

Pop It - Jason Dottley - JD3

S&M Rhianna - Def Jam / SRP

Higher - Taio Cruz Feat. Kylie Minogue & Travis McCoy - Mercury

You Can't Stop The Rain - Martin Clancy & The Witness Protection

Better Than Today - Kylie Minogue - EMI UK

Predator - Julissa Veloz - Carnillo

Last Days Of Disco - Robbie Williams - Capitol

Move On Fast - Yoko Ono - Twisted/Mind Train

Into The Light - Sk8 - Live Music / SK8

Get Outta My Way - Kylie Minogue - EMI UK

You Lost Me - Christina Aguilera - RCA

I told you so - Solange - Interscope Geffen

Reloaded - DJ Yiannis Compilation - Music Plant Group<br />

I Need Love - DJ Yiannis & Georgie Porgie - Music Plant Group<br />
Do It Again 2010 - Razor N' Guido Featuring Big Anthony & Sk8 - RNG<br />

I Wanna Be The One - Tony Cruz - Music Plant Group<br />

Give Me Luv 2010 -  Jean Philippe Starring Dihann Moore - Night Machine<br />

Smells Like A Teen Spirit 2010 - Nirvana Vs DJ Yiannis - DGC/Geffen<br />

Hey Boy - Radka - Six Avenue <br />

Beautiful U R - Deborah Cox - Deco <br />

Better In Time - Leona Lewis - BMG<br />

Candlelight - Jody Watley - Avitone <br />

I Like To Move In Here - Moby - Mute <br />

Is This Love 2010 - Bob Marley - Tuff Gong UK<br />

Don't Stop The Music - Rihanna - Island<br />

Mika - Relax - Casablanca <br />

Edge Of Seventeen - Stevie Nicks - WB<br />  

It's Got To Be Love - Rachel Panay - Act 2<br />

Into The Groove  - Madonna - Maverick<br />

Always Be Here For You - Joyce Sims - JS<br />

Ooh La Lishious - Jay Men - Marian <br />

Tina - Sk8 - SK8<br />

DreamGirls Mega Mix - Various - Altair<br />

Party People - Altar Featuring Jeanie Tracy - Mama House<br /> 

One Night Only (Dream Girls) - Scherrie Payne - Altair <br />

Black Horse And The Cherry Tree - KT Tunstall - Virgin/EMI UK<br />

Love Will Find A Way - Vernessa Mitchell  - Junior Vasquez Music<br />

Perfect Love - Simply Red - Verve/SR<br />

Try Yazz 2006 - Two Without Hats  - MicMac<br />

Nation - Sk8 - Tommy Boy Silver<br />

  How Can I Lie - Angel Faith - Midas<br /> 

    Feels Good - Dolce - Act 2 <br />

The Walk Of  Shame - Rachel Panay - Act 2 <br />

Toxic - Britney Spears - Jive<br />

Me, Myself And  I -  Beyonce'- Columbia<br />

Me Against the Music - Britney Spears Featuring Madonna - Jive<br />

Crazy in Love - Beyonce'- Columbia<br />
  
No Way No How - Jocelyn Enriquez  -  Next Plateau<br />

Automatic Lover - Jay Jay Johanson - RCA/BMG Sweden<br />

Don't You Want Me - Alcazar- BMG Sweden <br />

Candi - Joi Cardwell - Nomad <br />

  You Got The Love - The Source Featuring Candi Staton - TEC<br />

Who Do You Love - Deborah Cox - Arista <br />

Show Me Love - Robin S - Champion UK <br />

Yes- Amber - Tommy Boy Silver <br />

One More Time - Daft Punk - Virgin  <br />

Secret - Madonna - Maverick <br />

So Fabulous, So Fierce - Jocelyn Enriquez - Tommy Boy Silver<br />

Dancefloor - Octavhia - Groovelicious<br />

Believer - Ke' - Junior Vasquez Music <br />

Let The Music Play - Shannon - Contagious <br />

Give Me Tonight - Shannon - Contagious <br />

Heaven Is A Place on Earth - Belinda Carlisle - MCA UK<br /> 

He Is The Joy - Donna Allen - Soulforic <br />

It's Over Now - Deborah Cox - Arista<br />